1111111111111111111111
100000000P000001E00011
1000000000000000000011
10C0000011111111000001
1111100000000000000001
1000000011111100C00001
1111100000000001111111
10V0000000000000001111
1111111100000000011111
1100000000000000001111
100000001111111100C011
1111111111111111111111
