1111111111111111111111
1000C0000P000001E00011
10000010000C0000000C11
1000000111111111000001
1000000010000000000001
1000000011111111111111
100V000010000000000001
1000000110000111111111
1111111000000000011111
1100000000000000000011
1000000010000000000011
1111111111111111111111
