1111111111111111111111
1000000000000000E00011
1000001000000001000011
1000000111111000000001
1C00000010000000000001
10000CC011111111111101
1000000010000000000C01
10000C0010000111111111
1111111000000000011111
110000000000V000000011
1C000P0010000000000011
1111111111111111111111
