111111111
100000001
1C000P001
10000E001
1CCCCC001
10000CC01
10CCC0001
10000C001
111111111
