1111111111111111111111
100000000P00000E111111
1000000000000000111011
10C0000011000000000001
1111100000000000000001
100000001111000010V011
1111100000000011111111
1000000000000000001111
1111111100000000011111
1100000000000000001111
1000000011111111000011
1111111111111111111111
