111111111
10000C001
1C00P0001
10000E001
10C000C01
111111111
