1111111
10E00C1
1C00P01
1C00001
10C0001
100V001
1111111
1111111
