1111111
10E0PC1
1C00001
1C00001
10C0001
10V0001
1111111
1111111
