111111111
10E00C001
1C00P0001
1C0000001
10C000C01
111111111
